01/01/2020
13/04/2020
01/05/2020
08/05/2020
21/05/2020
01/06/2020
14/07/2020
15/08/2020
11/11/2020
25/12/2020
01/01/2021
05/04/2021
01/05/2021
08/05/2021
13/05/2021


